„..4·2...

eirer = god. era = and. dre (equile), unde: vegam. aren
ε ee. horsten = nisten (nidum fingere).

eise = soth. ezdts (commodus, facilis) = prov. ais = ite.
asio = agie.

aleove = alah-keve = ned. kofen (habitatio) (Grimm).

elene = aeg. elesne = she eluse sive elense sive ela (su-
bula) = nhd. ahle.

eleu afrg. = ahd. eldd sive alodis‘ffiiez), mm. allodium.

algier ee algeir (hasta) = and. azgdr = ane nord. etgeirr
(Grimm).

allemand = Allemannen.

ι eloee = aha. elause sivo elose = nde alose = else = else.

a·med0uer = sne nore. mete = ean. ling. made = god. mat3
jen (edere) (Diez).

amarrer = ade. marrjan = angl. ux. merran (impedire),
unde: emarrege, ddmarrer etc.

ambassade

ambassedeur

s'emuser = conf„ muserl

en'ehe (tubus) = aha. ancha (tibia, erus) (Diez).

angarde = i. e. ante-garde (vorhut), conr. garde.

arban = erg. harben = ed. heriban = nee. heerbann.

erchambau'd = and. erchambald.

arguet = aha. arahdn (nectere) (Grimm).

amand: she. herman.

ermde = proxime ex verbo armatus = arma = ex ane tent„ erm
= led ¹termus, unde transpose ramus (Grimm. Lex. III.)

arnaud = aee, arnulf. ’

ar-remir = goth. hremjen (cruci effigere), conr. aha. rdmdn
(petere) (Grimm).

zer-renger = and. rene == nhd. ring = ringen (eir-

arrengement cum egere).

ar-riser = goth. risen = she. rdsen (eadere, incidere).

’ aselle = nhd (wasser)·essel‚ undu asellotes.

= gom andbaht = ane ambaht = nde emt.

 

