..ημ-

1210 = m. „m laid = aaz. m. lad ε ma. m. ι. 1e10'<via ,
per silvam).

laisser = ahd. lam = goth: Ῑόίὸπ, = nt. su. Mn ιτ.
mm. lata = aha lmen (linquae).

lamfroy = apd. lassdffld (nom. pra).

lande = goth. land -τ and. lant = nna. land (verta). ’

landier = uno„ geulinder = eumn. lmder (Frisoh).

laper = angl. m. lapjan =⁴ ιω, laffon (lambere) = mn.
lappen = ι α lecken. ’

lavangesm walange muhaviae: malem: m lawine.

layette = mna lade = nna. lude.

lfioher = ana. lekehen sivo lekJ'm = m. lachen (lambere).

lest: nm lest aad. last = last. ,

leudes (plur.) = and. lut sive liut sive leud = nh'tu lente.

leurr'e = prov. ι loire. τ·- nm luoder -ε welze-(speive)
(Diez).

lippe = nna. lippe.

lis = itu. giglio = abd. lilio: mna gilge = nm. lilie (Diez). ’
lisse = aba. liso = nna. leise (levis, mollis), unde: lissam, -

’ neser, liusena, lienem limen. lissoir, fissura ato.

liste = and. liuta = nna. lintei οι laium, nm: lieibm.

lob& = anm lappa = und. lappe (Diez).

locher ως. = ana. loch (crinis) = mt.n01a.lockr (Diez).

lodier = md. lssdo (amiculum) = mt.n0ra.16d.

loge (villehardouin =10jer)=1uloggia = m. laubja av.
lauba = nno, habe, unae: logeable‚ logement, loger, lo-
geue, logan, logis. ’

longe = and} lancha (lumbo, ilium) = mad. lanke τ·- πω.
lende (ilium).

loque = and. loch (crinis) = ant„ nord„ lsskr = nm« locine,
unae: loqueum, ouse, loquetto.

loquet = it. luechetto = goth. ga-lfikar (claudere) =
ant nont loka = ansl- looh, to look (alaudem) unae: lo·
quemn, luquette.

 

